name:Lololol
width:20
height:20
floor:
37,37,37,37,37,37,37,37,37,37,37,37,37,37,37,37,37,37,37,37
37,37,37,37,37,37,37,37,37,37,37,37,37,37,37,37,37,37,37,37
37,37,37,37,37,37,37,37,37,37,37,37,37,37,37,37,37,37,37,37
37,37,37,37,37,37,37,37,37,37,37,37,37,37,37,37,37,37,37,37
37,37,37,37,37,38,38,38,38,38,37,37,37,37,37,37,37,37,37,37
37,37,37,37,37,37,37,37,37,38,37,37,37,37,37,37,37,37,37,37
37,37,37,37,37,37,37,37,37,38,37,37,37,37,37,37,37,37,37,37
37,37,37,37,37,37,39,39,39,39,37,37,37,37,37,37,37,37,37,37
37,37,37,37,37,37,39,37,37,39,37,37,37,37,37,37,37,37,37,37
37,37,37,37,37,37,39,39,39,39,37,37,37,37,37,37,37,37,37,37
37,37,37,37,37,38,38,38,38,38,37,37,37,37,37,37,37,37,37,37
37,37,37,37,37,37,37,37,37,38,37,37,37,37,37,37,37,37,37,37
37,37,37,37,37,37,37,37,37,38,37,37,37,37,37,37,37,37,37,37
37,37,37,37,37,37,37,37,37,37,37,37,37,37,37,37,37,37,37,37
37,37,37,37,37,37,37,37,37,37,37,37,37,37,37,37,37,37,37,37
37,37,37,37,37,37,37,37,37,37,37,37,37,37,37,37,37,37,37,37
37,37,37,37,37,37,37,37,37,37,37,37,37,37,37,37,37,37,37,37
37,37,37,37,37,37,37,37,37,37,37,37,37,37,37,37,37,37,37,37
37,37,37,37,37,37,37,37,37,37,37,37,37,37,37,37,37,37,37,37
37,37,37,37,37,37,37,37,37,37,37,37,37,37,37,37,37,37,37,37
walls:
20,19,19,19,19,19,19,19,19,19,19,19,19,19,19,19,19,19,19,18
13,0,0,0,0,0,0,0,0,0,0,0,0,0,0,0,0,0,0,17
13,0,0,0,0,0,0,0,0,0,0,0,0,0,0,0,0,0,0,17
13,0,0,0,0,0,0,0,0,0,0,0,0,0,0,0,0,0,0,17
13,0,0,0,0,0,0,0,0,0,0,0,0,0,0,0,0,0,0,17
13,0,0,0,0,0,0,0,0,0,0,0,0,0,0,0,0,0,0,17
13,0,0,0,0,0,0,0,0,0,0,0,0,0,0,0,0,0,0,17
13,0,0,0,0,0,0,0,0,0,0,0,0,0,0,0,0,0,0,17
13,0,0,0,0,0,0,0,0,0,0,0,0,0,0,0,0,0,0,17
13,0,0,0,0,0,0,0,0,0,0,0,0,0,0,0,0,0,0,17
13,0,0,0,0,0,0,0,0,0,0,0,0,0,0,0,0,0,0,17
13,0,0,0,0,0,0,0,0,0,0,0,0,0,0,0,0,0,0,17
13,0,0,0,0,0,0,0,0,0,0,0,0,0,0,0,0,0,0,17
13,0,0,0,0,0,0,0,0,0,0,0,0,0,0,0,0,0,0,17
13,0,0,0,0,0,0,0,0,0,0,0,0,0,0,0,0,0,0,17
13,0,0,0,0,0,0,0,0,0,0,0,0,0,0,0,0,0,0,17
13,0,0,0,0,0,0,0,0,0,0,0,0,0,0,0,0,0,0,17
13,0,0,0,0,0,0,0,0,0,0,0,0,0,0,0,0,0,0,17
13,0,0,0,0,0,0,0,0,0,0,0,0,0,0,0,0,0,0,17
14,15,15,15,15,15,15,15,15,15,15,15,15,15,15,15,15,15,15,16
entities:
player1 7,8
player2 8,8
