name:mdr
width:10
height:10
floor:
37,37,37,37,37,37,37,37,37,37
37,37,37,37,37,37,37,37,37,37
37,38,37,37,37,37,38,37,37,37
37,38,37,39,39,39,38,37,37,37
37,38,37,39,37,39,38,37,37,37
37,38,38,39,39,39,38,38,37,37
37,37,37,37,37,37,37,37,37,37
37,37,37,37,37,37,37,37,37,37
37,37,37,37,37,37,37,37,37,37
37,37,37,37,37,37,37,37,37,37
walls:
20,13,13,13,13,13,13,13,13,14
19,0,0,0,0,0,0,0,0,15
19,0,0,0,0,0,0,0,0,15
19,0,0,0,0,0,0,0,0,15
19,0,0,0,0,0,0,0,0,15
19,0,0,0,0,0,0,0,0,15
19,0,0,0,0,0,0,0,0,15
19,0,0,0,0,0,0,0,0,15
19,0,0,74,0,0,0,0,0,15
18,17,17,17,17,17,17,17,17,16
entities:
player2 8,3
player1 4,4
