name:pokemon
width:10
height:10
floor:
39,39,37,37,37,37,37,37,39,39
39,37,37,38,38,38,38,37,37,39
37,37,38,37,37,37,37,38,37,37
37,38,37,37,38,38,37,37,38,37
37,38,37,38,39,39,38,37,38,37
37,38,38,38,39,39,38,38,38,37
37,38,37,37,38,38,37,37,38,37
37,37,38,37,37,37,37,38,37,37
39,37,37,38,38,38,38,37,37,39
39,39,37,37,37,37,37,37,39,39
walls:
8,1,1,1,1,1,1,1,1,2
7,0,0,0,0,0,0,0,0,3
7,0,53,0,55,56,0,54,0,3
7,0,0,0,0,0,0,0,0,3
7,0,0,0,0,0,0,0,0,3
7,0,0,0,0,0,0,0,0,3
7,0,0,0,0,0,0,0,0,3
7,0,57,0,59,60,0,58,0,3
7,0,0,0,0,0,0,0,0,3
6,5,5,5,5,5,5,5,5,4
entities:
player1 4,4
player2 5,5
