name:portal
width:10
height:10
floor:
39,39,39,39,39,39,39,39,39,39
39,44,39,40,42,42,40,39,44,39
39,39,39,39,39,39,39,39,39,39
39,40,39,39,0,0,39,39,40,39
39,39,39,0,0,0,0,39,39,39
39,39,39,0,0,0,0,39,39,39
39,40,39,39,0,0,39,39,40,39
39,39,39,39,39,39,39,39,39,39
39,44,39,40,39,39,40,39,44,39
39,39,39,39,39,39,39,39,39,39
walls:
8,1,1,1,1,1,1,1,1,2
7,0,0,0,0,0,0,0,0,3
7,0,0,0,5,5,0,0,0,3
7,0,0,4,0,0,6,0,0,3
7,0,3,0,0,0,0,7,0,3
7,0,3,0,0,0,0,7,0,3
7,0,0,2,0,0,8,0,0,3
7,0,0,0,1,1,0,0,0,3
7,0,0,0,0,0,0,0,0,3
6,5,5,5,5,5,5,5,5,4
entities:
player1 1,2
player2 6,2