name:Test Map
width:9
height:8
floor:
37,37,37,37,37,37,0,37,37
37,37,37,37,37,37,0,37,37
37,37,37,37,37,37,37,37,37
37,37,37,37,37,37,37,37,37
37,37,37,37,37,37,37,37,37
37,37,37,37,37,37,0,0,0
0,0,0,0,0,0,0,0,0
0,0,0,0,0,0,0,0,0
walls:
12,1,1,1,1,9,0,8,1
7,0,0,0,0,3,0,7,0
7,0,0,0,0,0,1,0,0
7,0,0,0,0,0,0,0,0
7,0,0,0,0,0,4,6,5
11,5,5,5,5,10,0,0,0
0,0,0,0,0,0,0,0,0
0,0,0,0,0,0,0,0,0