name:very_big2
width:60
height:60
floor:
38,38,38,38,38,38,38,38,38,0,0,0,0,0,0,0,0,0,0,0,0,0,0,0,0,0,0,0,0,0,0,0,0,0,0,0,0,0,0,0,0,0,0,0,0,0,0,0,0,0,0,0,0,0,0,0,0,0,0,0
38,38,38,38,38,38,38,38,38,0,0,0,0,0,0,0,0,0,0,0,0,0,0,0,0,0,0,0,0,0,0,0,0,0,0,0,0,0,0,0,0,0,0,0,0,0,0,0,0,0,0,0,0,0,0,0,0,0,0,0
38,38,38,38,38,38,38,38,38,39,39,39,0,0,0,0,0,0,0,0,0,0,0,0,0,0,0,0,0,0,0,0,0,0,0,0,0,0,0,0,0,0,0,0,0,0,0,0,0,0,0,0,0,0,0,0,0,0,0,0
38,38,38,38,38,38,38,38,38,39,39,39,0,0,0,0,0,0,0,0,0,0,38,38,38,38,38,38,38,0,0,0,0,0,0,0,0,0,0,0,0,0,0,0,0,0,0,0,0,0,0,0,0,0,0,0,0,0,0,0
38,38,38,38,38,38,38,38,38,0,0,0,0,0,0,0,0,0,0,0,0,0,38,0,0,0,0,0,38,0,0,0,0,0,0,0,0,0,0,0,0,0,0,0,0,0,0,0,0,0,0,0,0,0,0,0,0,0,0,0
38,38,38,38,37,38,38,38,38,0,0,0,0,0,0,0,0,0,0,0,0,0,38,0,0,0,0,0,38,0,0,0,0,0,0,0,0,0,0,0,0,0,0,0,0,0,0,0,0,0,0,0,0,0,0,0,0,0,0,0
0,0,0,37,37,37,0,0,0,0,0,0,0,0,0,0,0,0,0,0,0,47,37,47,0,0,0,0,38,0,0,0,0,0,0,0,47,47,47,47,47,47,47,47,47,47,47,47,47,47,47,47,0,0,0,0,0,0,0,0
0,0,0,0,37,0,0,0,0,42,42,40,48,48,48,0,0,0,0,37,37,37,37,37,37,37,0,0,38,0,0,0,0,0,0,47,47,47,47,47,47,47,47,47,47,47,47,47,47,47,47,47,47,0,0,0,0,0,0,0
0,0,0,0,37,0,0,0,0,42,42,40,48,48,48,0,0,0,0,37,37,37,37,37,37,37,0,0,38,0,0,0,0,0,47,38,38,38,38,47,47,38,38,38,47,38,38,38,47,38,38,38,38,47,0,0,0,0,0,0
0,0,0,0,37,0,0,0,0,42,42,40,40,48,48,0,0,0,46,37,37,45,45,45,37,37,46,0,38,0,0,0,0,0,47,38,47,47,47,47,47,38,47,38,47,38,47,38,47,38,47,47,47,47,0,0,0,0,0,0
0,0,0,0,37,37,37,37,37,42,42,40,40,48,48,0,0,0,46,37,37,45,45,45,37,37,37,38,38,38,38,38,47,47,47,38,47,38,38,38,47,38,38,38,47,38,47,38,47,38,38,38,47,47,39,39,39,39,0,0
0,0,0,0,37,0,0,0,0,42,42,40,40,48,48,0,0,0,46,37,37,45,45,45,37,37,46,0,0,0,0,38,0,0,47,38,47,47,38,47,47,38,47,47,47,38,47,38,47,47,47,47,38,47,0,0,0,39,0,0
0,0,0,0,37,0,0,0,0,42,42,40,40,48,48,0,0,0,0,37,37,37,37,37,37,37,0,0,0,0,0,38,0,0,47,38,38,38,38,47,47,38,47,47,47,38,38,38,47,38,38,38,47,47,0,0,0,39,0,0
0,0,0,0,37,0,0,0,0,42,42,40,48,48,48,0,0,0,0,37,37,37,37,37,37,37,0,0,0,0,0,38,0,0,0,47,47,47,47,47,47,47,47,47,47,47,47,47,47,47,47,47,47,0,0,0,0,39,0,0
0,0,0,0,37,0,0,0,0,0,0,0,0,0,0,0,0,0,0,0,0,47,37,47,0,0,0,0,0,0,0,38,0,0,0,0,47,47,47,47,47,47,47,47,47,47,47,47,47,47,47,47,0,0,0,0,0,39,0,0
0,0,0,0,37,0,0,0,0,0,0,0,0,0,0,0,0,0,0,0,0,0,39,0,0,0,0,0,0,0,0,38,0,0,0,0,0,0,0,0,0,0,0,0,0,0,0,0,0,0,0,0,0,0,0,0,0,39,0,0
0,0,0,0,37,0,0,0,0,0,0,39,39,39,39,39,39,39,0,0,0,0,39,0,0,0,0,0,0,0,0,38,0,0,0,0,0,0,0,0,0,0,0,0,0,0,0,0,0,0,0,0,0,0,0,0,0,39,0,0
0,0,0,0,37,0,0,0,0,0,0,39,0,0,0,0,0,39,0,0,0,0,39,0,0,0,0,0,0,0,0,38,0,0,0,0,0,0,0,0,0,0,0,0,0,0,0,0,0,0,0,0,0,0,0,0,0,39,0,0
0,0,38,38,38,38,38,38,0,0,0,39,0,0,0,0,0,39,0,0,0,0,39,0,0,0,0,0,0,0,0,38,0,0,0,0,0,0,0,0,0,0,0,0,0,0,0,0,0,0,0,0,0,0,0,0,0,39,0,0
0,0,38,38,38,38,38,38,39,39,39,39,41,41,41,0,0,39,39,39,39,39,39,0,0,0,0,0,0,0,0,38,0,0,0,0,0,0,0,0,0,0,0,0,0,0,0,0,0,0,0,0,0,0,0,0,0,39,0,0
0,0,38,38,38,38,38,38,0,0,0,39,0,0,0,0,0,39,0,0,0,0,39,0,0,0,0,0,0,0,0,38,0,0,0,0,0,0,0,0,0,0,0,0,0,0,0,0,0,0,0,0,0,0,0,0,0,39,0,0
0,0,38,38,38,38,38,38,0,0,0,39,0,0,0,0,0,39,0,0,0,0,39,0,0,0,0,0,48,48,40,39,40,48,48,0,0,0,0,0,0,0,0,0,0,0,0,0,0,0,0,0,0,0,0,0,0,39,0,0
0,0,38,38,38,38,38,38,0,0,0,39,39,39,39,39,39,39,0,0,0,0,39,0,0,0,0,0,48,40,39,39,39,40,48,0,0,0,0,0,0,0,0,0,0,0,0,0,0,0,0,0,0,0,0,0,0,39,0,0
0,0,0,0,0,0,0,0,0,0,0,0,0,0,39,0,0,0,0,0,0,0,39,0,0,0,0,0,48,40,39,39,39,40,48,0,0,0,0,0,0,0,0,0,0,0,0,0,0,0,0,0,0,0,0,0,0,39,0,0
0,0,0,0,0,0,0,0,0,0,0,0,0,0,39,0,0,0,0,0,0,0,39,0,0,0,0,0,48,40,40,39,40,40,48,0,0,0,0,46,46,46,46,0,0,46,46,46,46,0,0,0,0,0,0,0,0,39,0,0
0,0,0,0,0,0,0,0,0,0,0,0,0,0,39,0,0,0,0,0,0,0,39,0,0,0,0,0,40,40,40,39,40,40,40,0,0,46,46,46,46,46,46,46,46,46,46,46,46,46,46,0,0,0,0,0,0,39,0,0
0,0,0,0,43,43,43,0,0,0,0,0,0,0,39,0,0,0,0,0,0,0,39,39,39,39,39,39,39,39,39,39,39,39,39,39,39,46,46,46,46,46,46,46,46,46,46,46,46,46,46,46,39,39,39,39,39,39,0,0
0,0,0,43,43,38,43,43,0,0,0,0,0,0,39,0,0,0,0,0,0,0,39,0,0,0,0,0,40,40,40,40,40,39,40,0,0,46,46,46,46,46,46,46,46,46,46,46,46,46,46,0,0,39,0,0,0,0,0,0
0,0,43,43,43,43,43,43,43,0,0,0,0,0,39,0,0,0,0,0,0,0,39,0,0,0,0,0,40,40,40,40,40,39,40,0,0,0,0,46,46,46,46,0,0,46,46,46,46,0,0,0,0,39,0,0,0,0,0,0
0,0,43,38,43,38,43,38,43,39,39,39,39,39,39,39,39,39,39,39,39,39,39,0,0,0,0,0,40,40,39,39,39,39,40,0,0,0,0,0,0,0,0,0,0,0,0,0,0,0,0,0,0,39,0,0,0,0,0,0
0,0,43,43,43,43,43,43,43,0,0,0,0,0,0,0,0,0,0,0,0,0,39,0,0,0,0,0,40,40,39,40,40,40,40,0,0,0,0,0,0,0,0,0,0,0,0,0,0,0,0,0,0,39,0,0,0,0,0,0
0,0,0,43,43,38,43,43,0,0,0,0,0,0,0,0,0,0,0,0,0,0,39,0,0,0,0,0,40,39,39,39,39,39,40,0,0,0,0,0,0,0,0,0,0,0,0,0,0,0,0,0,0,39,0,0,0,0,0,0
0,0,0,0,43,43,43,0,0,0,0,0,0,0,0,0,0,0,0,0,0,0,39,0,0,0,0,0,40,39,40,40,40,39,40,0,0,0,0,0,0,0,0,0,0,0,0,0,0,0,0,0,0,39,0,0,0,0,0,0
0,0,0,0,0,0,0,0,0,0,0,0,0,0,0,0,0,0,0,0,0,0,39,0,0,0,0,0,40,39,39,39,39,39,40,0,0,0,0,0,0,0,0,0,0,0,0,0,0,0,0,0,0,39,0,0,0,0,0,0
0,0,0,0,0,0,0,0,0,0,0,0,0,0,0,0,0,0,0,0,0,44,44,44,0,0,0,0,40,40,40,39,40,40,40,0,0,0,0,0,0,0,0,0,0,0,0,0,0,0,0,0,0,39,0,0,0,0,0,0
0,0,0,0,0,0,0,0,0,0,0,0,0,0,0,0,0,0,0,0,0,44,44,44,0,0,0,0,0,0,0,39,0,0,0,0,0,0,0,0,0,0,0,0,0,0,0,0,0,0,0,0,0,39,0,0,0,0,0,0
0,0,0,0,0,0,0,0,0,0,0,0,0,0,0,0,0,0,0,0,0,44,44,44,0,0,0,0,0,0,0,39,0,0,0,0,0,0,0,0,0,0,0,0,0,0,0,0,0,0,0,0,0,39,0,0,0,0,0,0
0,0,37,37,37,37,37,0,0,0,0,0,0,0,0,0,0,0,0,0,0,44,44,44,0,0,0,0,0,0,0,39,0,0,0,45,45,45,45,45,45,45,45,45,45,45,45,45,45,45,45,45,45,45,45,45,45,45,45,0
0,0,37,47,37,45,37,44,44,44,44,44,44,44,44,44,44,44,44,44,44,44,44,44,0,0,0,0,0,0,0,39,0,0,45,45,45,45,45,45,45,45,45,45,45,45,45,45,45,45,45,45,45,45,45,45,45,45,45,45
0,0,37,37,37,37,37,44,44,44,44,44,44,44,44,44,44,44,44,44,44,44,44,44,0,0,0,0,0,0,0,39,0,0,45,38,38,38,38,38,45,38,45,45,45,38,45,45,38,38,38,45,45,45,45,45,45,45,45,45
0,0,37,37,37,37,37,0,0,0,0,0,0,0,0,0,0,0,0,0,0,44,44,44,0,0,0,0,0,0,0,39,0,0,45,45,45,38,45,45,45,38,38,45,38,38,45,38,45,45,45,45,45,45,45,45,45,45,45,45
0,0,45,37,37,37,37,0,0,0,0,0,0,0,0,0,0,0,0,0,0,44,44,44,39,39,39,39,39,39,39,39,39,39,45,45,45,38,45,45,45,38,45,38,45,38,45,38,45,45,38,38,45,45,38,45,45,45,38,45
0,0,37,37,37,47,37,43,43,43,43,0,0,0,0,0,0,0,0,0,0,44,44,44,0,0,0,39,0,0,0,0,0,0,45,45,45,38,45,45,45,38,45,45,45,38,45,38,45,45,45,38,45,38,47,38,45,38,38,45
0,0,37,37,37,37,37,0,0,0,43,0,0,0,0,0,0,0,0,0,0,0,0,0,0,0,0,39,0,0,0,0,0,0,45,45,45,38,45,45,45,38,45,45,45,38,45,45,38,38,38,45,45,45,38,45,45,38,38,45
0,0,41,41,41,41,41,0,0,0,43,0,0,0,0,0,0,0,0,0,0,0,0,0,0,0,0,39,0,0,0,0,0,0,45,45,45,45,45,45,45,45,45,45,45,45,45,45,45,45,45,45,45,45,45,45,45,45,45,45
0,0,41,41,41,41,41,0,0,0,43,0,0,0,0,0,0,0,0,0,0,0,0,0,0,0,0,39,0,0,0,0,0,0,0,45,45,45,45,45,45,45,45,45,45,45,45,45,45,45,45,45,45,45,45,45,45,45,45,0
0,0,41,41,41,41,41,0,0,0,43,0,0,0,0,0,0,38,38,38,0,0,0,0,0,0,0,39,0,0,0,0,0,0,0,0,0,0,0,0,0,0,0,0,0,42,0,0,0,0,0,0,0,0,0,0,0,0,0,0
0,0,41,41,41,41,41,0,0,0,43,0,0,0,0,0,38,38,37,38,38,0,0,0,0,0,0,39,0,0,0,0,0,0,0,0,0,0,0,0,0,0,0,0,0,42,0,0,0,0,0,0,0,0,0,0,0,0,0,0
0,0,43,43,43,43,43,0,0,0,43,0,0,0,0,0,38,37,40,37,38,39,39,39,39,39,39,39,0,0,0,0,0,0,0,0,0,0,0,0,0,0,0,0,0,42,0,0,0,0,39,39,39,39,39,39,39,39,39,0
0,0,43,43,43,43,43,0,0,0,43,0,0,0,0,0,38,38,37,38,38,0,0,0,0,0,0,39,0,0,0,0,0,0,0,0,0,0,0,0,0,0,0,0,0,42,0,0,0,0,39,38,38,38,39,38,38,38,39,0
0,0,43,43,43,43,43,43,43,43,43,0,0,0,0,0,0,38,38,38,0,0,0,0,0,0,0,39,0,0,0,0,0,0,0,0,0,0,0,0,0,0,0,0,0,42,0,0,0,0,39,38,39,38,39,39,38,39,39,0
0,0,43,43,43,43,43,0,0,0,0,0,0,0,0,0,0,0,0,0,0,0,0,0,0,0,0,39,0,0,0,0,0,0,0,0,0,0,0,0,0,0,0,0,0,42,0,0,0,0,39,38,38,38,39,39,38,39,39,0
0,0,0,0,43,0,0,0,0,0,0,0,0,0,0,0,0,0,0,0,0,0,0,0,0,0,0,39,0,0,0,0,0,0,0,0,0,0,0,0,0,0,0,0,0,42,42,42,42,42,39,38,39,39,39,39,38,39,39,0
0,0,0,0,43,0,0,0,0,0,0,0,0,0,0,0,0,0,0,0,0,0,0,0,0,0,37,37,37,0,0,0,0,0,0,0,0,0,0,0,0,0,0,0,0,42,0,0,0,0,39,38,39,39,39,39,38,39,39,0
0,0,0,0,43,0,0,0,0,0,0,0,0,0,0,0,0,0,0,0,0,0,0,0,0,37,37,41,37,37,0,0,0,0,0,0,0,0,0,0,0,0,0,0,0,42,0,0,0,0,39,39,39,39,39,39,39,39,39,0
0,0,0,0,43,0,0,0,0,0,0,0,0,0,0,0,0,0,0,0,42,42,42,42,42,37,41,41,41,37,42,42,42,42,42,42,42,42,42,42,42,42,42,42,42,42,0,0,0,0,39,39,38,38,39,38,38,39,39,0
0,0,0,0,43,0,0,0,0,0,0,0,0,0,0,0,0,0,0,0,42,0,0,0,0,37,37,41,37,37,0,0,0,0,0,0,0,0,0,0,0,0,0,0,0,0,0,0,0,0,39,38,39,39,39,39,39,38,39,0
0,0,0,0,43,0,0,0,0,0,0,0,41,41,41,41,0,0,0,0,42,0,0,0,0,0,37,37,37,0,0,0,0,0,0,0,0,0,0,0,0,0,0,0,0,0,0,0,0,0,39,39,38,39,39,38,38,39,39,0
0,0,0,0,43,43,43,43,43,43,43,43,38,38,38,38,42,42,42,42,42,0,0,0,0,0,0,0,0,0,0,0,0,0,0,0,0,0,0,0,0,0,0,0,0,0,0,0,0,0,39,39,39,38,39,39,39,38,39,0
0,0,0,0,0,0,0,0,0,0,0,0,41,41,41,41,0,0,0,0,0,0,0,0,0,0,0,0,0,0,0,0,0,0,0,0,0,0,0,0,0,0,0,0,0,0,0,0,0,0,39,38,38,39,39,38,38,39,39,0
walls:
8,1,1,1,1,1,1,1,2,0,0,0,0,0,0,0,0,0,0,0,0,0,0,0,0,0,0,0,0,0,0,0,0,0,0,0,0,0,0,0,0,0,0,0,0,0,0,0,0,0,0,0,0,0,0,0,0,0,0,0
7,0,0,0,0,0,0,0,3,0,0,0,0,0,0,0,0,0,0,0,0,0,0,0,0,0,0,0,0,0,0,0,0,0,0,0,0,0,0,0,0,0,0,0,0,0,0,0,0,0,0,0,0,0,0,0,0,0,0,0
7,73,0,0,0,0,74,0,27,1,1,9,0,0,0,0,0,0,0,0,0,0,0,0,0,0,0,0,0,0,0,0,0,0,0,0,0,0,0,0,0,0,0,0,0,0,0,0,0,0,0,0,0,0,0,0,0,0,0,0
7,0,0,0,0,0,0,0,27,5,5,10,0,0,0,0,0,0,0,0,0,0,12,1,1,1,1,1,9,0,0,0,0,0,0,0,0,0,0,0,0,0,0,0,0,0,0,0,0,0,0,0,0,0,0,0,0,0,0,0
7,0,0,0,0,0,0,0,3,0,0,0,0,0,0,0,0,0,0,0,0,0,7,12,1,1,1,9,0,7,0,0,0,0,0,0,0,0,0,0,0,0,0,0,0,0,0,0,0,0,0,0,0,0,0,0,0,0,0,0
6,5,5,0,0,0,5,5,4,0,0,0,0,0,0,0,0,0,0,0,0,10,0,7,0,0,0,3,0,7,0,0,0,0,0,0,0,0,0,0,0,0,0,0,0,0,0,0,0,0,0,0,0,0,0,0,0,0,0,0
0,0,0,6,0,4,0,0,0,0,0,0,0,0,0,0,0,0,0,0,10,0,0,9,0,0,0,3,0,7,0,0,0,0,0,10,1,1,1,1,1,1,1,1,1,1,1,1,1,1,1,9,0,0,0,0,0,0,0,0
0,0,0,3,3,0,0,0,0,12,1,1,1,1,2,0,0,0,0,12,0,0,0,0,1,9,0,3,0,7,0,0,0,0,0,7,0,0,0,0,0,0,0,0,0,0,0,0,0,0,0,0,9,0,0,0,0,0,0,0
0,0,0,3,3,0,0,0,0,7,0,0,0,0,3,0,0,0,10,0,0,0,0,0,0,3,0,3,0,7,0,0,0,0,12,0,0,0,0,0,0,0,0,0,0,0,0,0,0,0,0,0,0,9,0,0,0,0,0,0
0,0,0,3,3,5,5,5,5,7,0,0,0,0,3,0,0,3,0,0,0,57,25,58,0,0,9,10,0,7,0,0,0,10,0,0,0,0,0,0,0,0,0,0,0,0,0,0,0,0,0,0,0,3,5,5,5,0,0,0
0,0,0,0,7,56,0,0,0,0,0,0,0,0,3,0,0,3,0,0,27,0,0,0,31,0,0,0,0,1,1,1,1,0,0,0,0,0,0,0,0,0,0,0,0,0,0,0,0,0,0,0,0,0,0,0,0,9,0,0
0,0,0,0,7,12,1,1,9,7,0,0,0,0,3,0,0,3,0,0,0,58,0,57,0,0,10,1,1,1,9,0,12,9,0,0,0,0,0,0,0,0,0,0,0,0,0,0,0,0,0,0,0,3,1,1,9,0,7,0
0,0,0,0,7,7,0,0,0,7,0,0,0,0,3,0,0,0,9,0,0,0,25,0,0,3,0,0,0,0,3,3,0,0,7,0,0,0,0,0,0,0,0,0,0,0,0,0,0,0,0,0,0,10,0,0,0,7,7,0
0,0,0,0,7,7,0,0,0,11,5,5,5,5,4,0,0,0,3,0,0,0,0,0,0,10,0,0,0,0,3,3,0,0,9,0,0,0,0,0,0,0,0,0,0,0,0,0,0,0,0,0,10,0,0,0,0,7,7,0
0,0,0,0,7,7,0,0,0,0,0,0,0,0,0,0,0,0,0,1,9,0,0,10,1,0,0,0,0,0,3,3,0,0,0,9,0,0,0,0,0,0,0,0,0,0,0,0,0,0,0,10,0,0,0,0,0,7,7,0
0,0,0,0,7,7,0,0,0,0,0,0,0,0,0,0,0,0,0,0,0,9,3,0,0,0,0,0,0,0,3,3,0,0,0,0,1,1,1,1,1,1,1,1,1,1,1,1,1,1,1,0,0,0,0,0,0,7,7,0
0,0,0,0,7,7,0,0,0,0,3,1,1,1,1,1,1,9,0,0,0,3,3,0,0,0,0,0,0,0,3,3,0,0,0,0,0,0,0,0,0,0,0,0,0,0,0,0,0,0,0,0,0,0,0,0,0,7,7,0
0,0,0,0,7,7,0,0,0,0,3,0,12,1,1,1,9,3,0,0,0,3,3,0,0,0,0,0,0,0,3,3,0,0,0,0,0,0,0,0,0,0,0,0,0,0,0,0,0,0,0,0,0,0,0,0,0,7,7,0
0,0,12,1,0,1,1,9,5,5,10,0,11,5,5,0,3,3,0,0,0,10,3,0,0,0,0,0,0,0,3,3,0,0,0,0,0,0,0,0,0,0,0,0,0,0,0,0,0,0,0,0,0,0,0,0,0,7,7,0
0,0,7,0,0,0,0,0,60,0,0,0,0,0,3,7,3,0,1,1,1,0,3,0,0,0,0,0,0,0,3,3,0,0,0,0,0,0,0,0,0,0,0,0,0,0,0,0,0,0,0,0,0,0,0,0,0,7,7,0
0,0,7,0,0,16,18,3,1,1,9,0,12,1,1,0,3,3,1,1,1,9,3,0,0,0,0,0,0,0,10,3,0,0,0,0,0,0,0,0,0,0,0,0,0,0,0,0,0,0,0,0,0,0,0,0,0,7,7,0
0,0,7,0,0,14,20,3,0,0,3,0,7,0,0,0,10,3,0,0,0,3,0,7,0,0,0,3,1,1,0,0,1,1,9,0,0,0,0,0,0,0,0,0,0,0,0,0,0,0,0,0,0,0,0,0,0,7,7,0
0,0,11,5,5,5,5,10,0,0,3,5,1,1,1,1,0,10,0,0,0,3,0,7,0,0,0,3,0,0,0,0,0,0,0,7,0,0,0,0,0,0,0,0,0,0,0,0,0,0,0,0,0,0,0,0,0,7,7,0
0,0,0,0,0,0,0,0,0,0,0,0,1,9,0,12,1,0,0,0,0,3,0,7,0,0,0,3,0,0,0,0,0,0,0,7,0,0,0,0,0,0,0,0,0,0,0,0,0,0,0,0,0,0,0,0,0,7,7,0
0,0,0,0,0,0,0,0,0,0,0,0,0,3,0,7,0,0,0,0,0,3,0,7,0,0,0,3,0,0,0,0,0,0,0,7,0,0,10,1,1,1,9,0,10,1,1,1,9,5,0,0,0,0,0,0,0,7,7,0
0,0,0,0,0,0,0,0,0,0,0,0,0,3,0,7,0,0,0,0,0,3,0,7,0,0,0,3,0,0,0,0,0,0,0,11,10,1,0,0,0,0,0,1,0,0,0,0,0,0,9,5,5,5,5,5,0,7,7,0
0,0,0,10,1,1,9,0,0,0,0,0,0,3,0,7,0,0,0,0,0,3,0,1,1,1,1,1,0,0,0,0,0,0,0,0,0,0,0,0,0,0,0,0,0,0,0,0,0,0,0,0,0,0,0,0,1,10,0,0
0,0,10,0,0,0,0,9,0,0,0,0,0,3,0,7,0,0,0,0,0,3,3,1,1,1,1,9,0,0,0,0,0,0,0,12,1,11,5,0,0,0,0,5,5,0,0,0,0,5,5,12,9,0,12,1,1,0,0,0
0,3,0,0,0,0,0,0,9,0,0,0,0,10,0,7,0,0,0,0,0,10,3,0,0,0,0,3,0,0,0,0,0,0,0,7,0,0,0,11,5,5,10,0,0,11,5,5,10,0,0,0,3,0,7,0,0,0,0,0
0,3,0,0,0,0,0,0,0,1,1,1,1,0,0,1,1,1,1,1,1,0,3,0,0,0,0,3,0,0,0,0,0,0,0,7,0,0,0,0,0,0,0,0,0,0,0,0,0,0,0,0,3,0,7,0,0,0,0,0
0,3,0,0,0,0,0,0,10,1,1,1,1,1,1,1,1,1,1,1,1,9,3,0,0,0,0,3,0,0,0,0,0,0,0,7,0,0,0,0,0,0,0,0,0,0,0,0,0,0,0,0,3,0,7,0,0,0,0,0
0,0,9,0,0,0,0,10,0,0,0,0,0,0,0,0,0,0,0,0,0,3,3,0,0,0,0,3,0,0,0,0,0,0,0,7,0,0,0,0,0,0,0,0,0,0,0,0,0,0,0,0,3,0,7,0,0,0,0,0
0,0,0,9,0,0,10,0,0,0,0,0,0,0,0,0,0,0,0,0,0,3,3,0,0,0,0,3,0,0,0,0,0,0,0,7,0,0,0,0,0,0,0,0,0,0,0,0,0,0,0,0,3,0,7,0,0,0,0,0
0,0,0,0,1,1,0,0,0,0,0,0,0,0,0,0,0,0,0,0,0,10,3,0,0,0,0,3,0,0,0,0,0,0,0,7,0,0,0,0,0,0,0,0,0,0,0,0,0,0,0,0,3,0,7,0,0,0,0,0
0,0,0,0,0,0,0,0,0,0,0,0,0,0,0,0,0,0,0,0,3,0,0,9,0,0,0,0,11,5,0,0,0,5,10,0,0,0,0,0,0,0,0,0,0,0,0,0,0,0,0,0,3,0,7,0,0,0,0,0
0,0,0,0,0,0,0,0,0,0,0,0,0,0,0,0,0,0,0,0,3,0,0,0,7,0,0,0,0,0,9,0,12,0,0,0,0,0,0,0,0,0,0,0,0,0,0,0,0,0,0,0,3,0,7,0,0,0,0,0
0,0,0,0,0,0,0,0,0,0,0,0,0,0,0,0,0,0,0,0,3,0,0,0,7,0,0,0,0,0,3,0,7,0,0,0,0,0,0,0,0,0,0,0,0,0,0,0,0,0,0,0,10,0,11,5,5,5,5,0
0,0,12,1,1,1,9,0,0,0,0,0,0,0,0,0,0,0,0,0,3,0,0,0,7,0,0,0,0,0,3,0,7,0,10,1,1,1,1,1,1,1,1,1,1,1,1,1,1,1,1,1,0,0,0,0,0,0,9,0
0,0,7,0,0,0,0,1,1,1,1,1,1,1,1,1,1,1,1,1,1,0,0,0,7,0,0,0,0,0,3,0,7,0,7,0,0,0,0,0,0,0,0,0,0,0,0,0,0,0,0,0,0,0,0,0,0,0,0,9
0,0,7,0,0,0,0,0,0,0,0,0,0,0,0,0,0,0,0,0,0,0,0,0,7,0,0,0,0,0,3,0,7,0,7,0,0,0,0,0,0,0,0,0,0,0,0,0,0,0,0,0,0,0,0,0,0,0,0,3
0,0,7,0,0,0,0,12,1,1,1,1,1,1,1,1,1,1,1,1,9,0,0,0,11,5,5,5,5,5,10,0,11,10,0,0,0,0,0,0,0,0,0,0,0,0,0,0,0,0,0,0,0,0,0,0,0,0,0,3
0,0,7,0,0,0,0,11,5,5,0,0,0,0,0,0,0,0,0,0,3,0,0,0,0,0,0,0,0,0,0,0,0,0,0,0,0,0,0,0,0,0,0,0,0,0,0,0,0,0,0,0,0,0,0,0,0,0,0,3
0,0,7,0,0,0,0,0,0,0,9,0,0,0,0,0,0,0,0,0,3,0,0,10,1,1,9,0,12,1,1,1,1,9,0,0,0,0,0,0,0,0,0,0,0,0,0,0,0,0,0,0,0,0,0,0,0,0,0,3
0,3,29,29,29,29,29,12,1,9,0,7,0,0,0,0,0,0,0,0,0,1,1,0,0,0,3,0,7,0,0,0,0,0,7,0,0,0,0,0,0,0,0,0,0,0,0,0,0,0,0,0,0,0,0,0,0,0,0,3
0,0,7,0,0,0,0,7,0,3,0,7,0,0,0,0,0,0,0,0,0,0,0,0,0,0,3,0,7,0,0,0,0,0,7,0,0,0,0,0,0,0,0,0,0,0,0,0,0,0,0,0,0,0,0,0,0,0,0,10
0,0,7,0,0,0,0,7,0,3,0,7,0,0,0,0,0,5,5,0,0,0,0,0,0,0,3,0,7,0,0,0,0,0,9,0,0,0,0,0,0,0,0,0,0,0,5,5,5,5,5,5,5,5,5,5,5,5,10,0
0,0,7,0,0,0,0,7,0,3,0,7,0,0,0,0,10,0,0,9,0,0,0,0,0,0,3,0,7,0,0,0,0,0,0,1,1,1,1,1,1,1,1,1,9,0,7,0,0,0,0,0,0,0,0,0,0,0,0,0
0,0,7,0,0,0,0,7,0,3,0,7,0,0,0,0,7,0,0,0,9,5,5,5,5,5,10,0,7,0,0,0,0,0,0,0,0,0,0,0,0,0,0,0,0,7,7,0,0,0,0,0,0,0,0,0,0,0,0,0
0,0,7,0,0,0,0,7,0,3,0,7,0,0,0,0,7,0,0,0,0,0,0,0,0,0,0,0,7,0,0,0,0,0,0,0,0,0,0,0,0,0,0,0,0,7,7,0,0,0,12,1,1,1,1,1,1,1,9,0
0,0,7,0,0,0,0,11,5,10,0,7,0,0,0,0,7,0,0,0,10,1,1,1,1,1,9,0,7,0,0,0,0,0,0,0,0,0,0,0,0,0,0,0,0,7,7,0,0,0,7,0,0,0,0,0,0,0,0,7
0,0,7,0,0,0,0,0,0,0,10,0,0,0,0,0,9,5,5,10,0,0,0,0,0,0,3,0,7,0,0,0,0,0,0,0,0,0,0,0,0,0,0,0,0,7,7,0,0,0,7,0,0,0,0,0,0,0,0,7
0,0,11,0,0,0,10,1,1,1,0,0,0,0,0,0,0,0,0,0,0,0,0,0,0,0,3,0,7,0,0,0,0,0,0,0,0,0,0,0,0,0,0,0,0,7,7,0,0,10,0,0,0,0,0,0,0,0,0,7
0,0,0,9,0,12,0,0,0,0,0,0,0,0,0,0,0,0,0,0,0,0,0,0,0,0,10,0,7,0,0,0,0,0,0,0,0,0,0,0,0,0,0,0,0,7,1,1,1,0,0,0,0,0,0,0,0,0,0,7
0,0,0,3,0,7,0,0,0,0,0,0,0,0,0,0,0,0,0,0,0,0,0,0,0,10,0,0,9,0,0,0,0,0,0,0,0,0,0,0,0,0,0,0,0,7,12,1,1,9,0,0,0,0,0,0,0,0,0,7
0,0,0,3,0,7,0,0,0,0,0,0,0,0,0,0,0,0,0,0,0,0,0,0,10,0,0,0,0,9,5,5,5,5,5,5,5,5,5,5,5,5,5,5,10,0,7,0,0,0,7,0,0,0,0,0,0,0,0,7
0,0,0,3,0,7,0,0,0,0,0,0,0,0,0,0,0,0,0,3,1,1,1,1,0,0,0,0,0,0,0,0,0,0,0,0,0,0,0,0,0,0,0,0,0,10,0,0,0,0,7,0,0,0,0,0,0,0,0,7
0,0,0,3,0,7,0,0,0,0,0,0,0,5,5,0,0,0,0,3,0,12,1,1,9,0,0,0,0,10,1,1,1,1,1,1,1,1,1,1,1,1,1,1,1,0,0,0,0,0,7,0,0,0,0,0,0,0,0,7
0,0,0,3,0,11,5,5,5,5,5,5,12,0,0,9,5,5,5,10,0,7,0,0,0,9,0,0,10,0,0,0,0,0,0,0,0,0,0,0,0,0,0,0,0,0,0,0,0,0,7,0,0,0,0,0,0,0,0,7
0,0,0,3,0,0,0,0,0,0,0,0,0,0,0,0,0,0,0,0,10,0,0,0,0,0,1,1,0,0,0,0,0,0,0,0,0,0,0,0,0,0,0,0,0,0,0,0,0,0,7,0,0,0,0,0,0,0,0,7
0,0,0,0,1,1,1,1,1,1,1,1,11,5,5,10,1,1,1,1,0,0,0,0,0,0,0,0,0,0,0,0,0,0,0,0,0,0,0,0,0,0,0,0,0,0,0,0,0,0,11,5,5,5,5,5,5,5,10,0
entities:
player1 1,2
player2 6,2
