name:The Whale
width:9
height:6
floor:
37,37,37,37,37,37,0,37,37
37,38,38,39,37,37,0,37,37
37,38,39,37,37,37,37,37,37
37,39,37,37,37,37,37,37,37
37,37,37,37,37,37,37,37,37
37,37,37,37,37,37,0,0,0
walls:
8,1,1,13,25,2,0,8,9
7,0,0,0,0,3,0,7,3
7,0,0,0,0,0,1,0,3
7,0,0,0,0,0,0,0,3
7,0,0,0,0,0,4,6,10
6,5,5,5,5,4,0,0,0
entities:
player1 2,2
player2 3,3